NO ./textures/redbrick.xpm
EA ./textures/purplestone.xpm     
WE ./textures/wood.xpm
F         255,     255   ,    0
C 0,0,255
SO ./textures/bluestone.xpm


11111111111111111111111111111111
10000000000000000000000000000001
10000010000000000000000001000001
10000100000000000000000000100001
10001000000000000000000000010001
10000000000000000000000000000001
10000000000000000000000000000001
100000000000000N0000000000000001
10001000000001111100000000010001
10000100000001   100000000100001
10000001000001111100000001000001
10000000000000000000000000000001
11111111111111111111111111111111