
NO ./textures/redbrick.xpm




EA ./textures/purplestone.xpm     


WE ./textures/wood.xpm



F         255,     255   ,    0
C 0,0,255


SO      ./textures/bluestone.xpm





        1111111 11111111111111111
        1000000 000110000000000001      11
        1000000 000110000000111111     1  1
        1000000 000110000001            111
        1011000 001110000000111111
        1001000 000000000000000001
111111111011000 001110000000000001
100000000011000 001110111111111111
111101111111110 11100000010001
111101111111110 11011010010001
110000001101010 1 11000000001
100000000000001 11100010000001
1000N0000000000 00110101001001
110000011101010 11111010000001
11110111 111010 1 101111010001
11111111 111111 1 111111111111
            
            
            

            



