
NO ./textures/redbrick.xpm




EA ./textures/purplestone.xpm     


WE ./textures/wood.xpm



F         255,     255   ,    0
C 0,0,255


SO      ./textures/bluestone.xpm





        11111111 1111111111111111111
        10000001 1000110000000000001      11
        10000001 1000110000000111111     1  1
        10000001 10001100000011           111
        10110001 1001110000000111111
        10010001 1000000000000000001
1111111110110001 1001110000000000001
1000000000110001 1001110111111111111
1111011111111101 11100000010001
1111011111111101 11111010010001
1100000011010101 1 110000000011
1000000000000011 111000100000011
1000N00000000001 100110101001001
1100000111010101 111110100000011
11110111 1110101 1 101111010001
11111111 1111111 1 111111111111
            
            
            

            



