




           NO ./textures/redbrick.xpm
C 0,0,255
WE ./textures/wood.xpm








SO      ./textures/bluestone.xpm




F         255,     255   ,    0
EA ./textures/purplestone.xpm  








   111
   101     11111
   111     10001
           10001
           11111


           

11111
10001
11111   111
        101
        111    

   
   