




           NO ./textures/redbrick.xpm
F         255,     255   ,    0
WE ./textures/wood.xpm


C 0,0,255





SO      ./textures/bluestone.xpm





EA ./textures/purplestone.xpm  







   111
   1E1     11111
   111     10001
           10001
           11111


           

11111
10001
11111   111
        101
        111    

   
   