 NO ./textures/redbrick.xpm
F 255,     255   ,    0
WE ./textures/wood.xpm
C 0,0,255
SO      ./textures/bluestone.xpm
EA ./textures/purplestone.xpm  


11111111111
10000000001
10111010001
101   10001
101111100N1
10000000001
11111111111
