 NO ./textures/redbrick.xpm
F 255,     255   ,    0
WE ./textures/wood.xpm
C 0,0,255
SO      ./textures/bluestone.xpm
EA ./textures/purplestone.xpm  

111111111111
100000000001
101111111001
101     1001
101 111 10N1
101 101 1001
101 10000001
111 11111111
